00000000000000000000000000000000000000000000000000000000000000000000000000000000000000000000000000000000000000000000000000000000000000000000000000000000000000000000000000000000000000000000000000000000000000000000000000000000
00000001010000000000000005050505050505050505020202020202020202020202020202020202020207070707070707070707010101010101010101010101010101010101010101010101010101010101010101010101010101010101010101010101010101010101010101010101
00000100000000000000000101010101010104020206010101010101040202060101010101010402020601010101010104020206010101010101040202060101010101010402020601010101010104020206010101010101040202060101010101010402020601010101010104020206
00000000000000010100000001010101010101010101010101010101010101010101010101010101010101010101010101010101010101010101010101010101010101010101010105050505050505050505020202020202020202020202020202020202020207070707070707070707
01000000000000000001000004020206010101010101040202060101010101010402020601010101010104020206010101010101040202060101010101010402020601010101010104020206010101010101040202060101010101010402020601010101010104020206010101010101
00000000000101000000000001010101010101010101010101010101010101010101010101010101010105050505050505050505020202020202020202020202020202020202020207070707070707070707010101010101010101010101010101010101010101010101010101010101
00010000000000000000010001010104020206010101010101040202060101010101010402020601010101010104020206010101010101040202060101010101010402020601010101010104020206010101010101040202060101010101010402020601010101010104020206010101
00010000000101000000010001010104020206010101010101040202060101010101010402020601010105050508020210050505020202020202020202020202020202020202020207070714020212070707010101040202060101010101010402020601010101010104020206010101
00000001010000000000010005050505050505050505020202020202020202020202020202020202020207070714020212070707010101040202060101010101010402020601010101010104020206010101010101040202060101010101010402020601010101010104020206010101
00000100000100000000000101010101010104020206010101010101040202060101010101010402020605050505050508020206020202020202020202060202020202020202020607070707070714020206010101010101040202060101010101010402020601010101010104020206
00010000000000010100000001010104020206010101010101040202060101010101010402020601010101010104020206010101010101040202060101010101010402020601010105050508020210050505020202020202020202020202020202020202020207070707070707070707
01000000000001000001000004020206010101010101040202060101010101010402020601010101010104020210050505050505040202020202020202020402020202020202020204020212070707070707040202060101010101010402020601010101010104020206010101010101
00000000010000000001000009050505050505050505040202020202020202020402020202020202020204020212070707070707040202060101010101010402020601010101010104020206010101010101040202060101010101010402020601010101010104020206010101010101
00000001000000000000000105050505050505050511020202020202020202060202020202020202020607070707070714020206010101010101040202060101010101010402020601010101010104020206010101010101040202060101010101010402020601010101010104020206
00000100000000010000000001010101010104020206010101010101040202060101010101010402020601010101010104020206010101010101040202060101010101010402020605050505050508020206020202020202020202060202020202020202020607070707070707070713
01000000000000000100000004020206010101010101040202060101010101010402020601010101010104020206010101010101040202060101010101010402020601010101010104020210050505050505040202020202020202020402020202020202020215070707070707070707
00000000010000000000010001010109050505050505010101040202020202020101010402020202020201010104020212070707010101040202060101010101010402020601010101010104020206010101010101040202060101010101010402020601010101010104020206010101
00000001000000000000010005050505050511010101020202020202060101010202020202020601010107070714020206010101010101040202060101010101010402020601010101010104020206010101010101040202060101010101010402020601010101010104020206010101
00010000000000010000000001010104020206010101010101040202060101010101010402020601010101010104020206010101010101040202060101010101010402020601010105050508020206010101020202020202060101010202020202020601010107070707070713010101
00010000000000000100000001010104020206010101010101040202060101010101010402020601010101010104020206010101010101040202060101010101010402020601010101010104020210050505010101040202020202020101010402020202020201010115070707070707
00000000000001000001000001010101010101010101010101010101010101010101010101010101010109050505050505050505040202020202020202020402020202020202020204020212070707070707040202060101010101010402020601010101010104020206010101010101
00000000000100000000000101010101010101010101010101010101010101010101010101010101010105050505050505050511020202020202020202060202020202020202020607070707070714020206010101010101040202060101010101010402020601010101010104020206
00000100000100000000000001010101010104020206010101010101040202060101010101010402020605050505050508020206020202020202020202060202020202020202020607070707070707070713010101010101010101010101010101010101010101010101010101010101
01000000000001000000000004020206010101010101040202060101010101010402020601010101010104020210050505050505040202020202020202020402020202020202020215070707070707070707010101010101010101010101010101010101010101010101010101010101
00000000000001000000010001010101010101010101010101010101010101010101010101010101010101010109050505050505010101040202020202020101010402020202020201010104020212070707010101040202060101010101010402020601010101010104020206010101
00000000000100000000010001010101010101010101010101010101010101010101010101010101010105050505050511010101020202020202060101010202020202020601010107070714020206010101010101040202060101010101010402020601010101010104020206010101
00010000000100000000000001010104020206010101010101040202060101010101010402020601010105050508020206010101020202020202060101010202020202020601010107070707070713010101010101010101010101010101010101010101010101010101010101010101
00010000000001000000000001010104020206010101010101040202060101010101010402020601010101010104020210050505010101040202020202020101010402020202020201010115070707070707010101010101010101010101010101010101010101010101010101010101