00000000000000000000000000000000000000000000000000000000000000000000000000000000000000000000000000000000000000000000000000000000000000000000000000000000000000000000000000000000000000000000000000000000
05050505050505050505020202020202020202020202020202020202020207070707070707070707010101010101010101010101010101010101010101010101010101010101010101010101010101010101010101010101010101010101010101010101
01010101010104020206010101010101040202060101010101010402020601010101010104020206010101010101040202060101010101010402020601010101010104020206010101010101040202060101010101010402020601010101010104020206
01010101010101010101010101010101010101010101010101010101010101010101010101010101010101010101010101010101010101010101010105050505050505050505020202020202020202020202020202020202020207070707070707070707
04020206010101010101040202060101010101010402020601010101010104020206010101010101040202060101010101010402020601010101010104020206010101010101040202060101010101010402020601010101010104020206010101010101
01010101010101010101010101010101010101010101010101010101010105050505050505050505020202020202020202020202020202020202020207070707070707070707010101010101010101010101010101010101010101010101010101010101
01010104020206010101010101040202060101010101010402020601010101010104020206010101010101040202060101010101010402020601010101010104020206010101010101040202060101010101010402020601010101010104020206010101
01010104020206010101010101040202060101010101010402020601010105050508020210050505020202020202020202020202020202020202020207070714020212070707010101040202060101010101010402020601010101010104020206010101
05050505050505050505020202020202020202020202020202020202020207070714020212070707010101040202060101010101010402020601010101010104020206010101010101040202060101010101010402020601010101010104020206010101
01010101010104020206010101010101040202060101010101010402020605050505050508020206020202020202020202060202020202020202020607070707070714020206010101010101040202060101010101010402020601010101010104020206
01010104020206010101010101040202060101010101010402020601010101010104020206010101010101040202060101010101010402020601010105050508020210050505020202020202020202020202020202020202020207070707070707070707
04020206010101010101040202060101010101010402020601010101010104020210050505050505040202020202020202020402020202020202020204020212070707070707040202060101010101010402020601010101010104020206010101010101
09050505050505050505040202020202020202020402020202020202020204020212070707070707040202060101010101010402020601010101010104020206010101010101040202060101010101010402020601010101010104020206010101010101
05050505050505050511020202020202020202060202020202020202020607070707070714020206010101010101040202060101010101010402020601010101010104020206010101010101040202060101010101010402020601010101010104020206
01010101010104020206010101010101040202060101010101010402020601010101010104020206010101010101040202060101010101010402020605050505050508020206020202020202020202060202020202020202020607070707070707070713
04020206010101010101040202060101010101010402020601010101010104020206010101010101040202060101010101010402020601010101010104020210050505050505040202020202020202020402020202020202020215070707070707070707
01010109050505050505010101040202020202020101010402020202020201010104020212070707010101040202060101010101010402020601010101010104020206010101010101040202060101010101010402020601010101010104020206010101
05050505050511010101020202020202060101010202020202020601010107070714020206010101010101040202060101010101010402020601010101010104020206010101010101040202060101010101010402020601010101010104020206010101
01010104020206010101010101040202060101010101010402020601010101010104020206010101010101040202060101010101010402020601010105050508020206010101020202020202060101010202020202020601010107070707070713010101
01010104020206010101010101040202060101010101010402020601010101010104020206010101010101040202060101010101010402020601010101010104020210050505010101040202020202020101010402020202020201010115070707070707
01010101010101010101010101010101010101010101010101010101010109050505050505050505040202020202020202020402020202020202020204020212070707070707040202060101010101010402020601010101010104020206010101010101
01010101010101010101010101010101010101010101010101010101010105050505050505050511020202020202020202060202020202020202020607070707070714020206010101010101040202060101010101010402020601010101010104020206
01010101010104020206010101010101040202060101010101010402020605050505050508020206020202020202020202060202020202020202020607070707070707070713010101010101010101010101010101010101010101010101010101010101
04020206010101010101040202060101010101010402020601010101010104020210050505050505040202020202020202020402020202020202020215070707070707070707010101010101010101010101010101010101010101010101010101010101
01010101010101010101010101010101010101010101010101010101010101010109050505050505010101040202020202020101010402020202020201010104020212070707010101040202060101010101010402020601010101010104020206010101
01010101010101010101010101010101010101010101010101010101010105050505050511010101020202020202060101010202020202020601010107070714020206010101010101040202060101010101010402020601010101010104020206010101
01010104020206010101010101040202060101010101010402020601010105050508020206010101020202020202060101010202020202020601010107070707070713010101010101010101010101010101010101010101010101010101010101010101
01010104020206010101010101040202060101010101010402020601010101010104020210050505010101040202020202020101010402020202020201010115070707070707010101010101010101010101010101010101010101010101010101010101