00 - 00000 - Blank
01 - 00202 - North
02 - 00404 - East
03 - 00606 - South
04 - 00808 - West
05 - 01010 - East to West
06 - 01212 - North to South
07 - 01414 - Crossroads
08 - 01616 - North T
09 - 01818 - East T
10 - 02020 - South T
11 - 02222 - West T
12 - 02424 - NW L
13 - 02626 - NE L
14 - 02828 - SE L
15 - 03030 - SW L
16 - 03232 - NW L center X
17 - 03434 - NE L center X
18 - 03636 - SE L center X
19 - 03838 - SW L center X
20 - 04040 - NW L center Y
21 - 04242 - NE L center Y
22 - 04444 - SE L center Y
23 - 04646 - SW L center Y
24 - 04848 - NW L center
25 - 05050 - NE L center
26 - 05252 - SE L center
27 - 05454 - SW L center

00 - 00000 - Blank
00000000000000000000
00000000000000000000
00000000000000000000
00000000000000000000
00000000000000000000
00000000000000000000
00000000000000000000
00000000000000000000
00000000000000000000
00000000000000000000

01 - 00202 - North
05050505050505050505
02020202020202020202
02020202020202020202
07070707070707070707
01010101010101010101
01010101010101010101
01010101010101010101
01010101010101010101
01010101010101010101
01010101010101010101

02 - 00404 - East
01010101010104020206
01010101010104020206
01010101010104020206
01010101010104020206
01010101010104020206
01010101010104020206
01010101010104020206
01010101010104020206
01010101010104020206
01010101010104020206

03 - 00606 - South
01010101010101010101
01010101010101010101
01010101010101010101
01010101010101010101
01010101010101010101
01010101010101010101
05050505050505050505
02020202020202020202
02020202020202020202
07070707070707070707

04 - 00808 - West
04020206010101010101
04020206010101010101
04020206010101010101
04020206010101010101
04020206010101010101
04020206010101010101
04020206010101010101
04020206010101010101
04020206010101010101
04020206010101010101

05 - 01010 - East to West
01010101010101010101
01010101010101010101
01010101010101010101
05050505050505050505
02020202020202020202
02020202020202020202
07070707070707070707
01010101010101010101
01010101010101010101
01010101010101010101

06 - 01212 - North to South
01010104020206010101
01010104020206010101
01010104020206010101
01010104020206010101
01010104020206010101
01010104020206010101
01010104020206010101
01010104020206010101
01010104020206010101
01010104020206010101

07 - 01414 - Crossroads
01010104020206010101
01010104020206010101
01010104020206010101
05050508020210050505
02020202020202020202
02020202020202020202
07070714020212070707
01010104020206010101
01010104020206010101
01010104020206010101

08 - 01616 - North T
05050505050505050505
02020202020202020202
02020202020202020202
07070714020212070707
01010104020206010101
01010104020206010101
01010104020206010101
01010104020206010101
01010104020206010101
01010104020206010101

09 - 01818 - East T
01010101010104020206
01010101010104020206
01010101010104020206
05050505050508020206
02020202020202020206
02020202020202020206
07070707070714020206
01010101010104020206
01010101010104020206
01010101010104020206

10 - 02020 - South T
01010104020206010101
01010104020206010101
01010104020206010101
01010104020206010101
01010104020206010101
01010104020206010101
05050508020210050505
02020202020202020202
02020202020202020202
07070707070707070707

11 - 02222 - West T
04020206010101010101
04020206010101010101
04020206010101010101
04020210050505050505
04020202020202020202
04020202020202020202
04020212070707070707
04020206010101010101
04020206010101010101
04020206010101010101

12 - 02424 - NW L
09050505050505050505
04020202020202020202
04020202020202020202
04020212070707070707
04020206010101010101
04020206010101010101
04020206010101010101
04020206010101010101
04020206010101010101
04020206010101010101

13 - 02626 - NE L
05050505050505050511
02020202020202020206
02020202020202020206
07070707070714020206
01010101010104020206
01010101010104020206
01010101010104020206
01010101010104020206
01010101010104020206
01010101010104020206

14 - 02828 - SE L
01010101010104020206
01010101010104020206
01010101010104020206
01010101010104020206
01010101010104020206
01010101010104020206
05050505050508020206
02020202020202020206
02020202020202020206
07070707070707070713

15 - 03030 - SW L
04020206010101010101
04020206010101010101
04020206010101010101
04020206010101010101
04020206010101010101
04020206010101010101
04020210050505050505
04020202020202020202
04020202020202020202
15070707070707070707

16 - 03232 - NW L center X
01010109050505050505
01010104020202020202
01010104020202020202
01010104020212070707
01010104020206010101
01010104020206010101
01010104020206010101
01010104020206010101
01010104020206010101
01010104020206010101

17 - 03434 - NE L center X
05050505050511010101
02020202020206010101
02020202020206010101
07070714020206010101
01010104020206010101
01010104020206010101
01010104020206010101
01010104020206010101
01010104020206010101
01010104020206010101

18 - 03636 - SE L center X
01010104020206010101
01010104020206010101
01010104020206010101
01010104020206010101
01010104020206010101
01010104020206010101
05050508020206010101
02020202020206010101
02020202020206010101
07070707070713010101

19 - 03838 - SW L center X
01010104020206010101
01010104020206010101
01010104020206010101
01010104020206010101
01010104020206010101
01010104020206010101
01010104020210050505
01010104020202020202
01010104020202020202
01010115070707070707

20 - 04040 - NW L center Y
01010101010101010101
01010101010101010101
01010101010101010101
09050505050505050505
04020202020202020202
04020202020202020202
04020212070707070707
04020206010101010101
04020206010101010101
04020206010101010101

21 - 04242 - NE L center Y
01010101010101010101
01010101010101010101
01010101010101010101
05050505050505050511
02020202020202020206
02020202020202020206
07070707070714020206
01010101010104020206
01010101010104020206
01010101010104020206

22 - 04444 - SE L center Y
01010101010104020206
01010101010104020206
01010101010104020206
05050505050508020206
02020202020202020206
02020202020202020206
07070707070707070713
01010101010101010101
01010101010101010101
01010101010101010101

23 - 04646 - SW L center Y
04020206010101010101
04020206010101010101
04020206010101010101
04020210050505050505
04020202020202020202
04020202020202020202
15070707070707070707
01010101010101010101
01010101010101010101
01010101010101010101

24 - 04848 - NW L center
01010101010101010101
01010101010101010101
01010101010101010101
01010109050505050505
01010104020202020202
01010104020202020202
01010104020212070707
01010104020206010101
01010104020206010101
01010104020206010101

25 - 05050 - NE L center
01010101010101010101
01010101010101010101
01010101010101010101
05050505050511010101
02020202020206010101
02020202020206010101
07070714020206010101
01010104020206010101
01010104020206010101
01010104020206010101

26 - 05252 - SE L center
01010104020206010101
01010104020206010101
01010104020206010101
05050508020206010101
02020202020206010101
02020202020206010101
07070707070713010101
01010101010101010101
01010101010101010101
01010101010101010101

27 - 05454 - SW L center
01010104020206010101
01010104020206010101
01010104020206010101
01010104020210050505
01010104020202020202
01010104020202020202
01010115070707070707
01010101010101010101
01010101010101010101
01010101010101010101
