000 - Blank
00000000000000000000000000
00000000000000000000
00000000000000000000
00000000000000000000
00000000000000000000
00000000000000000000
00000000000000000000
00000000000000000000
00000000000000000000
00000000000000000000
00000000000000000000

001 - Numbered Tiles
00000000000000000000000000
00010203040506070809
10111213141516171819
20212223242526272829
30313233343536373839
40414243444546474849
50515253545556575859
60616263646566676869
70717273747576777879
80818283848586878889
90919293949596979899

021 - Castle
01000100000000000000000000
01010104020206010101
01010104020206010101
01010104020206010101
01010104020206010101
01010104020206010101
01010104020206010101
01010119242420010101
01010123272725010101
01010122262621010101
01010101010101010101

031 - North
10000000010100000000000000
05050505050505050505
02020202020202020202
02020202020202020202
07070707070707070707
01010101010101010101
01010101010101010101
01010101010101010101
01010101010101010101
01010101010101010101
01010101010101010101

032 - East
10000001000000000000000001
01010101010104020206
01010101010104020206
01010101010104020206
01010101010104020206
01010101010104020206
01010101010104020206
01010101010104020206
01010101010104020206
01010101010104020206
01010101010104020206

033 - South
10000000000000000101000000
01010101010101010101
01010101010101010101
01010101010101010101
01010101010101010101
01010101010101010101
01010101010101010101
05050505050505050505
02020202020202020202
02020202020202020202
07070707070707070707

034 - West
10010000000000000000010000
04020206010101010101
04020206010101010101
04020206010101010101
04020206010101010101
04020206010101010101
04020206010101010101
04020206010101010101
04020206010101010101
04020206010101010101
04020206010101010101

035 - East to West
10000000000001010000000000
01010101010101010101
01010101010101010101
01010101010101010101
05050505050505050505
02020202020202020202
02020202020202020202
07070707070707070707
01010101010101010101
01010101010101010101
01010101010101010101

036 - North to South
10000100000000000000000100
01010104020206010101
01010104020206010101
01010104020206010101
01010104020206010101
01010104020206010101
01010104020206010101
01010104020206010101
01010104020206010101
01010104020206010101
01010104020206010101

037 - Crossroads
10000100000001010000000100
01010104020206010101
01010104020206010101
01010104020206010101
05050508020210050505
02020202020202020202
02020202020202020202
07070714020212070707
01010104020206010101
01010104020206010101
01010104020206010101

038 - North T
10000000010100000000000100
05050505050505050505
02020202020202020202
02020202020202020202
07070714020212070707
01010104020206010101
01010104020206010101
01010104020206010101
01010104020206010101
01010104020206010101
01010104020206010101

039 - East T
10000001000001000000000001
01010101010104020206
01010101010104020206
01010101010104020206
05050505050508020206
02020202020202020206
02020202020202020206
07070707070714020206
01010101010104020206
01010101010104020206
01010101010104020206

040 - South T
10000100000000000101000000
01010104020206010101
01010104020206010101
01010104020206010101
01010104020206010101
01010104020206010101
01010104020206010101
05050508020210050505
02020202020202020202
02020202020202020202
07070707070707070707

041 - West T
10010000000000010000010000
04020206010101010101
04020206010101010101
04020206010101010101
04020210050505050505
04020202020202020202
04020202020202020202
04020212070707070707
04020206010101010101
04020206010101010101
04020206010101010101

042 - NW L
10000000000100000000010000
09050505050505050505
04020202020202020202
04020202020202020202
04020212070707070707
04020206010101010101
04020206010101010101
04020206010101010101
04020206010101010101
04020206010101010101
04020206010101010101

043 - NE L
10000000010000000000000001
05050505050505050511
02020202020202020206
02020202020202020206
07070707070714020206
01010101010104020206
01010101010104020206
01010101010104020206
01010101010104020206
01010101010104020206
01010101010104020206

044 - SE L
10000001000000000100000000
01010101010104020206
01010101010104020206
01010101010104020206
01010101010104020206
01010101010104020206
01010101010104020206
05050505050508020206
02020202020202020206
02020202020202020206
07070707070707070713

045 - SW L
10010000000000000001000000
04020206010101010101
04020206010101010101
04020206010101010101
04020206010101010101
04020206010101010101
04020206010101010101
04020210050505050505
04020202020202020202
04020202020202020202
15070707070707070707

046 - NW L center X
10000000000100000000000100
01010109050505050505
01010104020202020202
01010104020202020202
01010104020212070707
01010104020206010101
01010104020206010101
01010104020206010101
01010104020206010101
01010104020206010101
01010104020206010101

047 - NE L center X
10000000010000000000000100
05050505050511010101
02020202020206010101
02020202020206010101
07070714020206010101
01010104020206010101
01010104020206010101
01010104020206010101
01010104020206010101
01010104020206010101
01010104020206010101

048 - SE L center X
10000100000000000100000000
01010104020206010101
01010104020206010101
01010104020206010101
01010104020206010101
01010104020206010101
01010104020206010101
05050508020206010101
02020202020206010101
02020202020206010101
07070707070713010101

049 - SW L center X
10000100000000000001000000
01010104020206010101
01010104020206010101
01010104020206010101
01010104020206010101
01010104020206010101
01010104020206010101
01010104020210050505
01010104020202020202
01010104020202020202
01010115070707070707

050 - NW L center Y
10000000000000010000010000
01010101010101010101
01010101010101010101
01010101010101010101
09050505050505050505
04020202020202020202
04020202020202020202
04020212070707070707
04020206010101010101
04020206010101010101
04020206010101010101

051 - NE L center Y
10000000000001000000000001
01010101010101010101
01010101010101010101
01010101010101010101
05050505050505050511
02020202020202020206
02020202020202020206
07070707070714020206
01010101010104020206
01010101010104020206
01010101010104020206

052 - SE L center Y
10000001000001000000000000
01010101010104020206
01010101010104020206
01010101010104020206
05050505050508020206
02020202020202020206
02020202020202020206
07070707070707070713
01010101010101010101
01010101010101010101
01010101010101010101

053 - SW L center Y
10010000000000010000000000
04020206010101010101
04020206010101010101
04020206010101010101
04020210050505050505
04020202020202020202
04020202020202020202
15070707070707070707
01010101010101010101
01010101010101010101
01010101010101010101

054 - NW L center
10000000000000010000000100
01010101010101010101
01010101010101010101
01010101010101010101
01010109050505050505
01010104020202020202
01010104020202020202
01010104020212070707
01010104020206010101
01010104020206010101
01010104020206010101

055 - NE L center
10000000000001000000000100
01010101010101010101
01010101010101010101
01010101010101010101
05050505050511010101
02020202020206010101
02020202020206010101
07070714020206010101
01010104020206010101
01010104020206010101
01010104020206010101

056 - SE L center
10000100000001000000000000
01010104020206010101
01010104020206010101
01010104020206010101
05050508020206010101
02020202020206010101
02020202020206010101
07070707070713010101
01010101010101010101
01010101010101010101
01010101010101010101

057 - SW L center
10000100000000010000000000
01010104020206010101
01010104020206010101
01010104020206010101
01010104020210050505
01010104020202020202
01010104020202020202
01010115070707070707
01010101010101010101
01010101010101010101
01010101010101010101
